####################### 日本 #######################
90126	志田達哉
1000325	木和田一臣
aichymia	福岡航太朗
amaru15	余正麒
asaringo	上野愛咲美
ascension5	志賀司
aterui	謝依旻
briskly	卞聞愷
bunbun	孔令文
bungo729	今分太郎
bwbrgt	関涼介
Callaway	井山裕太
candypop	高雄茉莉
cauj	小西和子
chevrolet	張瑞傑
chiffon	星合志保
choisasi	坂井秀至
cinnamon	五藤眞奈
clear777	金澤秀男
cocoa15	加藤千笑
curacao	横塚力
daidaiyung	蕭鈺洋
darkhorse7	六浦雄太
denbo	結城聡
dream09	藤沢里菜
enigma1	羽根彩夏
evc	田中伸幸
fantasy5	藤村洋輔
flowerwall(naotin0124)	大谷直輝
forestar	森智咲
gopro	広瀬優一
green0414	酒井佑規
gritar	西岡正織
hikick	大関稔
hiro120	小池芳弘
ideku15	曽富康
jin24	辻篤仁
jyoifuru	西健伸
kabutobu	坂井健太郎
kimian	蔡祈冕
lishang04	小西理章
lissome	姚智騰
mahoapo	大矢浩一
majician15	三根康弘
marny	大西竜平
matu15(松茶)	村松竜一
migurudia	藤井浩贵
mijinko	辻華
miligram	風間隼
milla517	高嶋湧吾
mirugai	鈴木伸二
momotan	万波奈穂
morisa15	蘇耀国
mrbater	村川大介
n1525	木部夏生
nagatake	瀬戸大樹
nanairo	関航太郎
nespresso	張豊猷
norakun21	村松大樹
novanova	鶴田和志
nuuho	平田智也
obabuchan	安藤和繁
oneokrock	佐田篤史
otowa	本木克弥
paleblue38	熊木熙弥
pamatan	柳井一真
pararakaie	常石隆志
popo1515	林漢傑
prolific	青木裕孝
pukino	渡辺寛大
risapooh	上野梨纱
rockmodo(rockmodo17)	大川拓也
saffy	三島響
sg2	大西研也
silvers7	伊田篤史
skyair 	一力遼
spaceline	安達利昌
Stelvio	高尾紳路
summerdive	小山空也
swing	柳時熏
takosu8	三戸秀平
takoyaki	大竹優
teacookie	渡辺由宇
tiger	依田紀基
tlearn	芝野虎丸
tosayuhi	中小野田智己
touchdown	河英一
trsy	寺田柊汰
uver	新谷洋佑
wilbert92	陈柏劭
wildboar15	表悠斗
ああもんど(aamondo)	下島陽平
あかし焼き(akashiyaki)	重川明司
アダム(adamu1219)	八幡直樹
いごえもん(igoemonn)	池本遼太
宇宙制覇(yk1002)	田中佑樹
銀翼大鷲(galeeagle7)	河原裕
クワイガン(quigon)	河野臨
ゴンベ(nikumaru)	谷口徹
しょうや(syoya)	中野奨也
シルシ(sirusi)	村本渉
せんとくん(sentokun)	田中康涌
ダンク(dunk1)	阿部良希
ちびまじん(tibimajin)	豊田裕仁
つばめ5(tsubame5)	徐文燕
でぇもん(demon8528)	大表拓都
鳩の化身(doraemon55)	松本武久
またたき(matataki)	首藤瞬
まめろう(mamerou)	青木喜久代
みゅう(myuh)	芝野龍之介
みんと(mintea)	並木響
ゆでたろう(yudetaro)	三浦太郎
リルモア(litlemore)	外柳是聞
わかば(wakaba)	秋山次郎
わせあや(waseaya)	小林光一
わたこう(watanabe1)	渡辺貢規
囲碁星人z(spaceman)	大橋拓文
羽根直树	羽根直樹
王铭琬	王銘琬
感到困(sleepyeyed)	河野光樹
観測者614(yunionwave)	桑原駿
棋海遊龍(adidas12)	許家元
激辛会計士(ascpa)	大熊悠人
古樹旋律(deemo96)	森川舜弐
向井千瑛	向井千瑛
才悩人(sainoujin)	内海晃希
山下敬吾	山下敬吾
散歩(zenkyuu)	栗田佳樹
初雪	牛栄子
小林觉	小林覚
深夜特急(nighttrain)	仲邑信也
生茶(namatya)	呉柏毅
青星111(blue18)	沼舘沙輝哉
石田芳夫	石田芳夫
大竹英雄	大竹英雄
天空心(skywin)	王景弘
刀鬼神(toukizinn)	近藤登志希
東亜重工(sidonia)	中濵孝ノ輔
梅泽由香里(吉原由香里)	吉原由香里
半炒飯(friedrice)	潘善琪
武宮正樹(武宫正树)	武宮正樹
分福茶釜(enigma999)	三谷哲也
夢風船(15balloon)	柳原咲輝
龍の牙(ryunokiba)	竹下凌矢
龍的伝人(kingpapa)	王立誠
鈴木歩(铃木步)	鈴木歩
蜻蛉切(kodomo)	李沂修
張栩（张栩）	張栩
赵治勋	趙治勲
飞田早纪(tobisaki15)	飛田早紀

####################### 韓国 #######################
575469(화룡점정)	郑宇津
abc17	柳珉瀅
ace98(에이s)	郭圓根
achimsan(흑백소년)	梁鍾燦
admas(위버멘쉬)	玄釉斌
airforce9(에어포스원)	金志錫
andromath	李賢虎
apeach3(어피치)	曹承亚
asaiah	金榮光
asyou(유레카)	金彩瑛
balyongee(발핼꿈꾸며)	金大容
biba2017	金承俊
bibibig	崔哲瀚
bigears	白現宇
bigstrong(괴동)	崔精
blackpink(별의전쟁)	李志賢
bundong(미스터리)	李炯珍
ccwwkk(완득이)	赵完珪
ch990901	崔暎賛
chic9949(썸머타임)	文敏钟
cing123(레전더리)	金玧台
coreaface(감성)	宋知勲
dhkdxhfl(왕토리)	柳珠儇
dlwotjd	李宰成
dmddksdid(응안양)	崔珉瑞
docta(오라클)	楊民錫
dolsung(신서유기)	宋相勲
doojeje(뚜제제)	都恩教
dorhsl(바품바품)	宋泰坤
dragon13(용가리통뼈)	兪炳龍
drama11(드라마)	洪晙善
ebichu06(에비츄)	金孝英
ekstn1(침대바둑)	姜升旼
fiona	權孝珍
firmino(피르미누)	姜知勳
fkdldjs	金珉舒
flash77	朴河旼
fohens	朴承华
gadros1	金旻奭
gangnam(강남바둑)	韓文德
gayang	黄鎭亨
ghffksem(흘란스럽다)	徐儁雨
goguma(옥수수셤차)	韓升周
goldstone	金成龍
goodpcm	朴滄溟
han0612(전국의계란)	韓宇進
harnn	白洪淅
hijhhh(재하빠)	徐武祥
icis(시그널)	李元荣
ilsik(일면식)	安祚永
imkc0210(워커흘릭)	任敬讚
jbs360(마사카)	朴常鎮
jendeuk(치츄)	金裕撰
jhba0425(사나마나)	朴鐘勳
jin2016	金奇彦
joonki	徐能旭
kjjang03(카피바라)	金河润
kke0416	金京垠
lcarus(이카루스)	金昌勋
lee55(낭만바둑)	李映九
maeum(속마음)	姜儒澤
maker	朴廷桓
miracle97(미라클)	卞相壹
mire32	仲邑菫
monomono	趙南均
mvpcurry(흥국재영이)	朴硬根
nator3000(두터운사과)	韓逎永
nesiggu1	韩相朝
newsong(다들어와)	丁勳鉉
nice111(나이스)	劉栽豪
NICKSGO	金恩持
nomeng(코엘료)	金檽里
noremorse(후회없이)	金明訓
nparadigm(카운트다운)	申真諝
obw12345(살인미소)	吴秉祐
onereeler(파노라마)	崔正冠
opening97(그곳에서서)	崔烘允
physical(레이나)	崔宰栄
piaojie	姜東潤
pms0329(겸둥임)	李熙星
ppjh(멍멍이)	朴只玹
pyh	朴永訓
qkrrjsgh(렛츠기릿)	朴鍵昊
riley21(라일리)	李瑟珠
rkdfkfzld	梁寓皙
rlwkdrns1(월시코기1)	奇旼燦
Rodrygo(호드리구)	洪世煐
sahyl(사할묘기)	權孝珍
sfruit	林義現
shadowpow(순실박)	趙漢乗
shine15(길을따라6)	金康旻
shoxtv	朴貞根
skssmsvmfh(나는프로)	朱炫禹
sky0132(리바이병장)	申有旻
skyblue0(오아시스)	李映周
smallpooh(꼬마푸우)	呉侑珍
sniper111(저격)	朴鍵昊
sniperkill(불패신화)	申旻埈
son7(감스트)	申载元
sorrymom(몰디브한잔)	金世东
spinmove(크리스폴)	安成浚
spring(소나무)	李東勲
ssunil66	尹閔重
startup05(러너웨이)	朴東柱
sy0921	朴昭律
terror0(테러리스트)	金宣圻
tmch(시간과낙엽)	崔禹首
transurfer(트랜서퍼)	朴伸英
trap7	金秀勇
twicett(유수부쟁선)	白賛僖
veryeasy	朴鎭鍈
warriors1(듀란트)	沈载益
wedtoon(대학일기)	朴大荣
whgnwjd	趙宗信
whiplash	鄭斗鎬
wjh2005(길동)	元齊焄
wlaud(스이바)	金志明
wnstjq1	沈准燮
wonfun	元晟溱
woonsai (YWPark)	朴永云
yang08177(볼레낭기)	梁洧準
yh7525(엠지엠)	許映皓
金真辉(김진휘)	金眞輝
武無無敵(무무무적)	金昌勲

####################### 中国 #######################
88888888	尹航
Algorithm8	文兆京
anciman	鄭淼鑫
Avenger007	王尭
azzjzq	杭小童
bestwish(滴水成冰)	秦悦欣
Bigticket	劉元博
black2012	李欽誠
braveheart	胡鈺函
chaosha(兰晓晓)	周賀璽
Chelsea(車路士)	楊楷文
chenyichun(中国卫视)	陳一純
chenyuch	李建宇
Chtho11y	汪希如
CYZW(江湖大侠)	李修全
dander	曽志豪
Darwiner(达尔文)	佟禹林
Dayline(Curry7)	陈翰祺
deathnotei	瞿鸣
Dekss	尹渠
DuanY(段誉)	檀嘯
fantasy123(暮青云)	陳一鳴
feihua(飞花逐水流)	季力立
Flyinghear(Flyhigher)	王澤錦
fqishi01(局道)	謝科
FUJIANH7（梦境缔造者）	FuJH
Fukua(浮夸)	呉樹浩
ghostparty	蔡文鑫
grace孤城(风骨上人)	丁浩
haohao2013(皓龙)	黄晨
hcyhcr(风清扬)	胡耀宇
hikarihe(恬淡晴天)	李欣宸
hwhhzmk（冰柠薄荷糖）	張銘康
iceiceice	張亜博
Ido(灵狐)	張東岳
INDIANA13(印城之霸)	辜梓豪
jason1993(吃喝玩乐)	蔡競
jiajiababy(炭烤大灰狼)	周元俊
jingjing(我想静静了)	党毅飛
jingting(静听风雨)	胡躍峰
jingwoxin(Oathy)	李小溪05
just1992	彭立尭
karroyjack(盛夏的暗恋)	趙奕斐
kelly216(kelly水晶)	曹又尹
kongm(孔明)	黄雲嵩
LANXIONG(JinYC)	金禹丞
lcs1999	李成森
leaf(炼心)	時越
LenkaK	公彦宇
Lucifer(天地皆酔)	孫騰宇
lvjingasd(冤枉)	曹瀟陽
magic	李源鯤
meteor	劉星
Mohist	韓墨陽
Monody(龙门阵)	古霊益
MYT(MiYTing)	芈昱廷
NightCome(天启)	江維傑
NIPOHC	韓一州
pangfeizhu(迈克尔肥猪)	王雷
peach(桃桃)	張策
persevere(陌路河西)	蒋其潤
planelord（位面之主）	李澤豪
qingfengmy(天魔星)	朱駿寰
qiruitian(圣托里尼)	田瑞祺
Quinn（峨眉渔樵）	屠晓宇
riyuezhix(日月之行)	張学斌
sdlw(神的礼物)	李響
sehgs65(XuJYang)	許嘉陽
shishenzhe(弑神者)	鄭宇航
shuimen(齐天X)	陳翰祺
singlesong(单身情歌)	范胤
sisi(黄奕中)	黄奕中
SJGJ(杺樾)	张馨月
smile(时间之虫)	楊鼎新
Snipes(Snipers)	陳豪鑫
snowbaby（小魔女1122）	吴依铭
SSMMD(风吹梦醒)	黄一鳴
starfell（星落东方）	李東方
steadfast(陆承轩)	羅洗河
Steve(卢天圣)	盧天聖
strict1(克己慎独)	黄昕
tangerine（天选）	柁嘉熹
tdcq	李翔宇
Terminator(终结者5)	謝爾豪
TheOne2020	王澤萱
tjx222(轩轩必胜客)	湯靖軒
TMC(顺利过关)	童夢成
tokaiteio(嘉然diana)	王硕
tuyt(固化剂)	戎毅
vegetarian(绝代天骄)	李豪傑
wilone（三目中林）	李維清
wujiany(七杀)	廖元赫
XIALUOTLL(幽魂魅影)	丁世雄
xiyue（喜越）	楊智文
xxpp4123	李必奇
yingyitao(慢慢下)	應一韜
ykpcx(FanTYu)	范廷鈺
ylbwq(娱乐版围棋)	許斐然
zhangyim(无心思量)	張一鳴
zhaohoujin(小心我哦)	赵后金
ziniu(子曾牛过)	牛雨田
zxuexue(楚门的世界)	劉曦
ZYH66(北回归线66)	曾渊海
玄妙qcy	秦驰远
以量取胜	何鑫
横跨帝国(时光列车)	王世一
佳佳1028	岳佳妍
我有点醉	陳揚
雅塔雷斯(plutofy)	沈沛然
皆忘	汪涛
寒光铁衣	芮乃伟
完杀(一笑奈合)	柳琪峰
看月听雨	厳歓
危楼高百尺	安冬旭
机动	夏晨琨
逆袭丿暴走	国宇征
曲子(乘风破蒗)	万乐奇
禁断9	尹松濤
血色风凌	伊凌濤
月下孤星	汪逸塵
言心合一	江铸久
古剑焚寂	高恬亮
交易员	毛睿龍
光之绚影梦	陳棟如
向秋森花	王磊
沙小沫	周昱杉
使徒信经	婁洛寧
子落风云起	羅徳隆
子弹随风飘	董明
思想的星空	趙晨宇
死神永生	張涛
若只如初见	孫力
酒梦愁殇曲	王若宇
修罗炼狱	王澤宇
秋天的老虎	陳昱森
小花像小花(鹰在飞F)	战鹰
小香馋猫	常昊
少年游	韓晗
庄子秋水(超然lly)	吕立言
消逝棋子声	徐金陽
信督	林子杰
神王崛起(水仙L)	陳正勲
神剑九万里	WangYC
神话傳说	李勲政
神龙之息(大胖西瓜)	王碩
澄公(词语)	陳文政
世间飘雪	周正心
星宿老仙	古力
星之所在	韋一博
清泉石上流	周睿羊
清淡天和	李思璇
生之绚烂	孙明杰
逝去的孤影	陳賢
雪域青莲(心静依兰)	周泓余
仙衣	黄明宇
潜伏	柯潔
爽歪歪	王爽
争不恣狂荡	黄春棋
送你的独白	石金昊
戴京京	戴琪高
拓荒勇士	厳在明
淡淡淡	王昊洋
知音漫客(欢欢2009)	羅岩
中の道	趙中暄
天域之神(春之祭)	石豫来
天下无双	陶 然
天天向前AB (Yin)	尹成志
道是心常平(护世剑心)	鶉光亜 
内圣外王	王哲明
任我行棋	陸敏全
白头到老(无心爱棋)	喬智健
浮生清梦(谁的寂寥)	徐澤鑫
北海的早晨	范蘊若
命中丿注定	蒋蔚
摸连奴	李华嵩
木兰朵朵(田鼠宝宝)	李赫
夜黑雨紧	陳必森
夕惕若厉	李喆
夕阳的泪痕	胡傲華
落下的尘土	盧笛
林书豪	于富霖
冰冷记忆	方昊
咆哮	陳梓健
很懒的猫	彭筌
愿我能	孟泰齢
无痕	於之瑩
霸dao	王檄
胖铭铭	李銘
霍华德	花畅
琪琪学棋	王嘉琪
专心如我	張歆宇
刘小嘟	王晨星
剑过无声	連笑
势如破竹1 (LiHT)	李昊潼
吴子路	呉天
啥名都有	董彦
奋励 (HuZH)	胡子豪
宁汐	賈欣怡
弈帆风顺	蔡碧涵
时修	高宇
时间管理	何語涵
杀心通明(WangCH)	王春晖
渔岛风	王星昊
疯狂羊	杨宗煜
疯子	廖行文
碰触彩虹	王音灵水
红昭愿C(徒手摘星丶)	陈蔓淇
终南山	宋容慧
绝命毒师1	朱彦臻
诸神的荣耀	唐韋星
谜团(ChenYYe)	陳耀燁
质直若神	楊文鎧
还我河山(triathlon)	劉宇航
这这破孩子	李康
钱宇平	銭宇平
隐秘的角部	王晨帆
韩笑天下(鬼凝神迷)	钱留儒
风烟俱尽(ZhengZX)	郑载想
龙奔	李祝

####################### 台湾 #######################
030102(豬豬熊)	劉耀文
1992peter(林修平)	林修平
98mark	謝承翰
agasi123(棋妙筋奇)	盧奕銓
angel0412	白昕卉
boby2000	陳威廷
boltgo	周可平
brian234	林新為
bullking(平天大聖)	牛詩特
chijordan（流星之絆）	林柏宇
cpbl(柏融大王)	林書陽
crystal07	林鈺娗
cuteone(迷你黑布丁)	陳詩淵
dannis728	高昀
eason000(視界之霸)	徐靖恩
eating66（心曠神怡）	林怡廷
fatengo(胖胖豬寶)	黃宥騰
gino0408(均輔武士)	頼均輔
hgtuhiugf(閃耀的星空)	李漢驎
ioloi	党希昀
jack12132（鍥而不捨）	沈逸恩
jasper92(鱒魚)	張嘉桓
jbr(薑餅人)	簡靖庭
legend8842(legend0429)	俞俐均
lina16	陳品樺
Mooose	張凱馨
mouse0910(弈鼠知秋)	林宇翔
nightraid1(乂菜月昴乂)	林彥丞
onlyyouqaq（勢在必行）	詹宜典
owleye	盧鈺樺
pupudiban	陳禧
qoqhan(啾啾丸)	林傑漢
raccoonzs(怪獸浣熊)	林士勛
SkyRaker(席格那汀)	陳祈睿
spirit800（800鬥志）	施景堯
sunliyan（謹言慎行）	孫立言
twkoala	廖冠泓
watinsin（夾心餅乾）	李嘉馨
wec0120（靈威棐諶）	吳彥諶
wenshin(0唯有努力0)	孫偉勛
William124	陳首廉
yubin0202	余炳葟
yuuki0523(聖母聖詠)	王智弘
ziggler(cesaro)	許育祺
一花一天堂	許皓鋐
玩圈圈	王元均
棋游少年	林立祥
神來一手	蕭正浩
星空的淚水	蘇聖芳
低語森林悄(雪納瑞)	周平強
白金之星	周俊勳
風起	李維
楊博崴	楊博崴
林小牛	林君諺
傳承偉大(恆星的恒心)	蔡丞韋
澳洲小肥羊	楊子萱
黑嘉嘉	黑嘉嘉
为无限	黃袖圃